자영업	NNG
자영업자	NNG
신기술	NNG
적법	NNG
불법	NNG
소득주도성장	NNG
좌파독재정권	NNG
자국민	NNG
자문화	NNG
탈원전	NNG
소상공인	NNG
공수처	NNP
명예직	NNG
선거제도	NNG
사법	NNG
대전환	NNG
인하	NNG
상한제	NNG
탈탄소	NNG
주권화폐	NNG
재수사	NNG
감사	NNG
다문화	NNG
종부세	NNP
최저학력	NNG
리모델링	NNG
유니콘기업	NNG
디벨로퍼	NNP
변이	NNG
변이종	NNG
오미크론	NNP
자치도	NNG
전도유망	NNG
국민의 힘	NNP
최일선	NNG
프로게스테론	NNG
큐레이션	NNG
일요휴무제	NNP
유전무죄	NNG
주권국가화	NNG	
사문서위조	NNG
이륜오토바이크	NNG	
파광부	NNG
블라디보스톡	NNP
유무선 통신	NNG
순혈	NNG
바우처	NNG
연구개발비	NNG
타임오프	NNG
건보료	NNP
신도시	NNG
미디어	NNG
택소노미	NNP
국격	NNG
기본소득	NNG
돌봄	NNG
불공정	NNG
소규모	NNG
대규모	NNG
확성화	NNG
재외동포	NNG
온실가스	NNG
감경요소	NNG
약제비	NNG
농어촌	NNG
상병수당	NNG
한미	NNG
한일	NNG
한미일	NNG
한미중	NNG
한중일	NNG
한중	NNG
한중러	NNG
남북미	NNG
미중	NNG
참고사전	NNG
포랜식	NNG
사법농단	NNG
스타트업	NNG
N번방	NNP
월세	NNG
감리자	NNG
카르텔	NNG
청구권	NNG
국공립대학	NNG
융복합	NNG
정례화	NNG
정의	NNG
물적	NNG
펜데믹	NNG
활성화	NNG
근로시간	NNG
국정운영	NNG
상설화	NNG
다이버시티	NNG
농어촌	NNG
그린노믹스	NNG
신한울	NNP
중지권	NNG
농어업	NNG
보장제	NNG
운임제	NNG
소환제	NNG
이사제	NNG
안보비	NNG
시민	NNG
다차원	NNG
군복무	NNG
관사병	NNG
숙박	NNG
한시	NNG
상시	NNG
발의	NNG
철밥통	NNG
코로나	NNP
공익	NNG
지식공유부	NNP
고위공직자범죄수사처	NNP
채용	NNG
전국민	NNG
전세계	NNG
의석	NNG
탈시설	NNG
건강보장	NNG
권리보장	NNG
병상	NNG
주권재민	NNG
성인지	NNG
파독	NNG
체덕지	NNG
쌍벌죄	NNG
국영화	NNG
민영화	NNG
최첨단	NNG
이송	NNG
거주	NNG
최소화	NNG
최대화	NNG
이상자	NNG
초중등	NNG
빅테이터	NNG